Ayssa Pen And The Chiba Ladies – Rieba Pua
Michel Moers – Bébé Tout Ou Rien
Takenoko – Trans Amor Express
Data – Data Plata
David Michal Cross – Future Man
Kingsley Bucknor – Don’t Give Up Ya Luv
Carlos – C’est Bon, Salsa
David Appel Group – Feeling Fire
Orbital – Walk Now
Melike Demirag – Gurbet Turkusu
Panthera Krause – Genki Girl
Madame – Quand Tout Va Par Deux
Joe Marino – The Force
Morceau Mystèèère – n°25
Bonheur Du Jour – Radio Je T’Aime
Patrizia Brindani – Ma Tu
V.O. – C’est Comme Ca L’été
Pino Daniele – Ferryboat
Fischerspooner – Horizon
Pierre Bachelet – Hors-Piste
Floco Floco – On M’a dit…
Miro – Carly
Dazion – Dancing In The Future
EMS 250 – Virage
Will Powers – Dancing For Mental Health
Los Lopez – EOPD (Brassica Remix)
Traumprinz – Where Is Home?
Joe hisaishi – Silent Love
All Saints – Pure Shores
Middle Sky Boom – Souvenirs
Manu Louis – Internet
Amaya – Sensation
Mike Francis – Let Me In
Philippe Nicaud – C’Ex
Alexandra – Fantasia
Continental Research Orchestra – Naboko Samba
Osamu Kitajima – Beyond The Circle
Anne Haigis – Feuilleton Ballade
Nkono Teles – Martin Street Special
Martin Matiske – Kammermusik
New York Pig Funkers – Tomato Grosso
Chapeau Claudette – Fashion C’est La Latest Attraction
An Luu – Pourquoi Tu Me Fous Plus Des Coups
Die Wilde Jagd – 2000 Elefanten
Eric Cosaque – Guadaloupe Ile de Mes Amours
Rex Brown Company – Act Of Threat
